#####
#   ##
#A@  ##
## @  #
 ## @ # 
  ##  # 
   ##o#
    #o#
    #o#
    ###