####
#  ####
#  #  ##
#A@    #
##o @  #
 #o@####
 #o #
 ####