######
##   #
#  @ #
#o@#o#
#  @A#
#  o##
######